20 13
3 2 2 2 2 2 2 2 2 2 2 2 2 2 2 2 2 2 2 4
1 0 0 0 0 3 2 2 4 0 0 0 0 0 0 0 0 0 0 7
1 0 0 0 0 1 0 0 1 0 0 0 0 0 0 0 0 0 0 1
1 0 0 0 0 1 0 0 1 0 0 0 0 0 0 0 0 0 0 1
1 0 0 0 0 5 2 2 6 0 0 3 2 2 2 4 0 0 0 1
1 0 0 0 0 0 0 0 0 0 0 1 0 0 0 1 0 0 0 1
1 0 0 0 0 0 0 0 0 0 0 1 0 0 0 1 0 0 0 1
1 0 0 0 3 2 2 2 4 0 0 5 2 2 2 6 0 0 0 1
1 0 0 0 1 0 0 0 1 0 0 0 0 0 0 0 0 0 0 1
1 0 0 0 1 0 0 0 1 0 0 0 0 0 0 0 0 0 0 1
1 0 0 0 1 0 0 0 1 0 0 0 0 0 0 0 0 0 0 1
1 0 0 0 1 0 0 0 1 0 0 0 0 0 0 0 0 0 0 1
5 2 2 2 6 0 0 0 5 2 2 2 2 2 2 2 2 2 2 6

