25 20
3 2 2 4 3 2 2 2 2 2 2 2 2 2 2 2 2 2 2 2 2 2 2 4 
1 0 0 1 5 2 2 2 2 2 2 2 2 2 2 2 2 2 2 2 4 0 0 1
1 0 3 6 0 0 0 0 0 0 0 0 0 0 0 0 0 0 0 0 0 0 0 1
1 0 1 0 0 3 2 2 2 2 4 0 0 0 0 0 0 3 2 4 0 0 0 1
1 0 1 0 0 1 0 0 0 0 5 2 4 0 0 0 0 5 2 6 0 0 0 1
1 0 1 0 0 5 2 4 0 0 0 0 1 0 0 0 0 0 0 0 0 0 0 1
1 0 1 0 0 0 0 1 0 3 2 2 6 0 0 0 0 0 0 0 0 0 0 1
1 0 1 0 0 0 0 1 0 1 0 0 0 0 0 0 0 0 3 2 4 0 0 1
1 0 0 0 0 0 0 1 0 1 0 0 0 0 0 0 0 0 5 2 6 0 7 1
1 0 0 0 3 2 2 6 0 1 0 0 0 0 3 2 4 0 0 0 0 0 0 1
1 0 0 0 1 0 0 0 0 1 0 0 0 0 5 2 6 0 0 0 0 0 0 1
1 0 0 0 5 2 2 2 2 6 0 0 0 0 0 0 0 0 0 3 2 4 0 1
1 0 0 0 0 0 0 0 0 0 0 0 0 0 0 0 0 0 0 5 2 6 0 1
1 0 0 0 0 0 0 0 0 0 0 0 3 2 2 2 2 4 0 0 0 0 0 1
1 0 0 3 2 2 2 2 2 4 0 0 1 0 0 3 2 6 0 0 0 0 0 1
1 0 0 1 0 0 0 0 0 1 0 0 1 0 0 1 0 0 0 0 0 0 0 1
1 0 0 5 2 2 2 4 0 1 0 0 1 0 0 1 0 0 3 2 4 0 0 1
1 0 0 0 0 0 0 1 0 1 0 0 5 2 2 6 0 0 5 2 6 0 0 1
1 0 0 0 0 0 0 5 2 6 0 0 0 0 0 0 0 0 0 0 0 7 0 1
5 2 2 2 2 2 2 2 2 2 2 2 2 2 2 2 2 2 2 2 2 2 2 6
