25 22
0 0 0 0 0 0 0 3 2 2 2 2 2 2 2 2 2 2 2 2 2 2 2 2 4 
0 0 0 0 0 0 0 1 3 2 4 0 0 0 0 0 0 0 0 0 0 0 0 0 1 
0 0 0 0 0 0 0 1 1 7 1 0 3 2 2 2 2 2 2 2 0 0 0 0 1 
0 0 0 0 0 0 0 1 1 0 0 0 1 0 0 0 0 0 0 0 0 0 0 0 1 
0 0 0 0 0 0 0 1 1 0 0 0 1 0 0 0 0 0 0 0 0 0 0 0 1 
3 2 2 2 2 2 2 6 5 2 2 2 6 0 0 0 3 2 2 2 0 0 0 0 1
1 0 0 0 3 2 2 2 2 2 2 2 2 0 0 0 1 0 0 0 0 0 0 0 1 
1 0 0 0 1 0 0 0 0 0 0 0 0 0 0 0 1 0 0 3 2 2 2 4 1 
1 0 0 0 1 0 3 2 2 2 2 2 4 0 0 0 1 0 0 5 2 2 2 6 1 
1 0 0 0 1 0 5 2 2 2 2 2 6 0 0 0 1 0 0 2 2 2 2 4 1 
1 0 0 0 1 0 0 0 0 0 0 0 0 0 0 0 1 0 0 0 0 0 0 1 1 
1 0 0 0 5 2 2 2 2 2 2 2 2 0 0 0 1 0 0 2 2 2 2 6 1 
1 0 0 0 0 0 0 0 0 0 0 0 0 0 0 0 1 0 0 0 0 3 2 2 6 
1 0 0 0 0 0 0 0 0 0 0 0 0 0 0 0 1 0 0 0 0 5 2 2 4 
1 0 3 2 2 4 0 0 0 0 0 0 0 0 0 0 1 0 0 0 0 0 2 2 6 
1 0 1 0 0 1 0 3 2 2 2 2 2 4 0 0 1 0 0 0 0 0 0 7 0 
1 0 1 0 0 1 0 1 0 0 0 0 0 1 0 0 5 2 2 2 2 2 2 2 4 
1 0 5 4 0 1 0 1 0 0 0 0 0 1 0 0 0 0 0 0 0 0 0 0 1 
1 0 0 1 0 1 0 1 0 0 0 0 0 1 0 0 3 2 2 2 2 2 2 4 1 
1 0 0 1 0 1 0 1 0 0 0 0 0 1 0 0 5 2 2 2 2 2 2 6 1 
1 0 0 0 0 0 0 1 0 0 0 0 0 1 0 0 0 0 0 0 0 0 0 0 1 
5 2 2 2 2 2 2 6 0 0 0 0 0 5 2 2 2 2 2 2 2 2 2 2 6 